^^^^^^^^^^^^^^^^^^^^^^^^
________________________
_________________W_W_W_X
________________________
_______________W________
_____________W_________W
_____W_W_W_W____________
S__W+++++++++++++++W++++