__________WW
__________WW
____________
____________
____________
_____WW____X
S____WW_____