^W^^^^^^^^^W^^^^^^^^^^^^^^^^^^^^^^^^WW_F_F_WWW
_______________________________________+_+_WWW
_______________________________________WWW_WWW
_______________________________________^^W_WWW
___WWWWW_W__W_WWWW___WWWW_W___W_WWW______W_WWW
___^^W^^_WE_W_W_F____W____WW__W_W__W_____W_WWW
_____W___WWWW_WWW____WWW__W^W_W_W__W_____W_WWW
_____W___W__W_WF_____W____W_^WW_W__W_____W_WWW
_____W___W__W_WWWW___WWWW_W___W_WWW______W_WWW
______________________K_____E____________W_WWW
S____________________E___WWWWWW__________W_D_X
W++++++++++++++W++++WW++++++++++W++++++++WWWWW