_D__^_^__^__WWW^
XWW_________WKW_
WWW_____________
___WWWWW+WW_____
________WW___E__
_+_______W_WWWWW
_W____WW_W______
____E_W__WWWWW__
S_WWWWW_________