____________
WWWWWW__WWWW
______WW____
____________
____________
______WW____
______WW___X
S_____WW____