^^^^^^^^^^^^^^^^^^^^^^^^^^^^^^^^^^^^^^^^^^^^^^^^^^^^^^^^^^^^^^^^^
______________________________________________W____WWWWW______W__
_____________________________W_____W_____W____W____WWWW^_W____W__
___WW_________________________________________W____WW^W_______W__
______________________________________________WWWWWW__________W__
_________WWW__________________________________W^^^^W__________W__
S_____________________________________________________________W__
W______________________WW+WW+++WWW+++WWW+++WWWW_______________W__
__________________WW+WW__W__WWW___WWW___WWW___WW_W_W__________W__
_______WW____WW+WW__W_________________________W_+_+W__________W__
_______________W______________________________W_W_WW_____X____W__
+++++++++++++++W++++++++++++++++++++++++++++++++W+W++++++W+++++++