^^^^^^^^^^^^^^^^^^^^^^^^^^^^^^^^^^^^^^^^^
____WWW___________W______________________
____________WWW__________________________
_______________________________W_W_______
____________________WWW__________________
_________________________________________
___________________________W____W________
S__W+++W+W+W+++W+W+W+++W+W+++W+++++W____X