S_W^^__K_
W_W______
W_W__WW_
__W__W__
_E__W___
WW_W_D_E
__+_XWWW