__WK___FWW_^_F___F__
S_W_E___W___________
W_WWWWW_____W+__+___
___F______WWWWWWWWW_
WE___E_W_WW^_____^__
WWWWWWWWWWW___+_____
X__^_D__W^^__WWWWWWW
_+___W__________E___