WWWWWW__WWWW
__F___WW____
____________
X____WW_____
WWWWW_^WWW__
___F________
S___W__E____