_^^^W^___WF_____
____K____W+__WWX
___E_E___WWW__WW
_WWW_WWWWW_D___W
__F_____FW_WWWWW
_________W______
_E____E__WWWW++_
_WWWWWWWWW___WW_
S__________W____