^^^^^^^^^^^^^^^^^^^^^^^^^^^^^^^^^^^^^^^^^
____WWW___________W______________________
____________WWW__________________________
_________________________________________
____________________WWW__________________
_________________________________________
___________________________W____W________
S__W+++W+W+W+++W+W+W+++W+W+++W+++++W____X