__________WW
WWWWW_____WW
____________
____________
____________
______WW____
______WW___X
S_____WW____