_^^^W^___WE_____
____K____W+__WWX
___E_E___WWW__WW
_WWW_WWWWW_D___W
________EW_WWWWW
_________W______
_E_______WWWW++_
_WWWWWWWWW___WW_
S__________W____