^^^^^^^^^^^^^^^^^^^^^^^^
________________________
_______________________X
_________________W_W_W__
_______________W________
_____________W____W_W__W
S____W_W_W_W____________
___W+++++++++++++++W++++