WW_W________
XD_D_WE_____
WWWWWWWWWWW_
__^____^____
S__EW_E_____
WWWWWWWWWW_W
_____^^W_W__
__EWKE_W___W
_WWWWWWW____
__F_________
E____EWE____
WW_K_WWWE__E