_^_^__^__
S___E____
W___WWW_W
___WK_^__
__EW___E_
WWWWWWWW_
_WF______
XD___W__W
WWE__WE__