WWWWW_______
WWWW______X_
WWW______WWW
WW______W___
W______W___W
______W___WW
_____W___WWW
____W___WWWW
S__W___WWWWW