__________WW
________WWWW
______WW____
______WW____
____________
______WW____
______WW___X
S_____WW____