__________WW
__________WW
____________
____________
____________
____________
___________X
S___________