________________________
______________________X_
_________________W_W_W__
_______________W________
_____________W____W_W___
_______W___W____________
____W______________W____
S_______________________