_X_______________F_____________WWW
_______________E_____WWWWWWW_____F
E_______WWWWWWWWWWWWW______F______
WWWWWWWW___FWF____________________
WWWWWWWW_W__E_____________E_______
_______F_^__WWWWWWW__WWWWWWWWWWWWW
__________________F__W___W___W___W
S__WW__E__W__________W___W___W___W