WWWWWWWWWWWW
WWWWW__WWWWW
WWWW____WWWW
WWW______WWW
WW________WW
W____WW____W
_____WW_____
S____WW____X