__________WW
__________WW
____________
____________
____________
____________
____________
S_____W____X