^^^^^^^^^^^^^^^^^^^^^^^^
______________________X_
_________________W_W_W__
_______________W________
_____________W____W_W___
_______W_W_W____________
____W______________W____
S__W____++____________++