W_W_W_W_W_W_W_W_W_W_W_W_
_W_W_W_W_W_W_W_W_W_W_W_W
WWWWWWWWWWWWWWWWWWWWWWWW
_W______________________
W_____________________X_
________________________
________________________
S________+++____________