^^^^^^^^^^^^^^^^^^^^^^^^
_______________________W
_________________W_W_W_X
________________________
_______________W________
_____________W__________
_____W_W_W_W____________
S__W+++++++++++++++W++++