_WWF____W^W^W__F_F_F_^WWW
WWW___+_______________D_X
_F__WWW_____K________WWWW
S_++____+_+________+WWWWW
WWWW____W+W++_____+WWWWWW