__________WW
__________WW
____________
____________
____________
____________
____________
S__________X