WWW___^W_F_D_F_
WW^__E_W___W+__
F___WW_K+_WWWW_
__WWWW__W_WX___
S_WWWW_E__WW+__